%%%%%%%%%%%%%%%%%%%%%%%%%%%%%%%%
%     %%%P% %              % %%%
%%%%%   % % %%%%%% %%%%% % % %%%
%       %        %     % %     %
%%%%% %%%%% %%% %% %%%%% % %%% %
%   % % % %   %    %     %   % % 
% %%% % % % %%%%%%%% %%% %%% % %
%       %     %%.    % % %   % %
%%% % %%%%%%% %%%% %%% % % %   %
% %           %%           % %%%
% % %     % %%%% % %%% %%% % %%%
%   %     % %    % %   % %%% %%%
%   %P%%%%%      % %%% %     %%%
%%%%%%%%%%%%%%%%%%%%%%%%%%%%%%%%
